2 2 2 2 2 2 2 2 2 2 2 2 2 2 2 2 2 2 2 2 2 3 1 1 1 3 2 2 2 2 2 2 2 2 2 2 2 2 2 2 2 2 2 2 2 2 2 2
6 6 6 6 6 3 8 8 8 8 8 8 8 8 8 8 8 8 8 6 6 3 1 1 1 3 6 6 6 6 6 6 6 6 6 6 6 6 6 6 6 6 6 6 6 6 6 6
6 6 6 6 6 6 6 6 6 6 6 6 6 6 6 6 6 6 8 6 6 3 1 1 1 3 6 6 6 6 6 6 6 6 6 6 6 6 6 6 6 6 6 6 6 6 6 6
6 6 6 6 6 6 6 6 6 6 6 6 6 6 6 6 6 6 8 8 8 3 1 1 1 3 6 6 6 6 6 6 6 6 6 6 6 6 6 6 6 6 6 6 6 6 6 6
6 6 6 6 6 6 6 6 6 6 6 6 6 6 6 6 6 6 6 6 6 3 1 1 1 3 6 6 6 6 6 6 6 6 6 6 6 6 6 6 6 6 6 6 6 6 6 6
6 6 6 6 6 6 6 6 6 6 6 6 6 6 6 6 6 6 6 6 6 3 1 1 1 3 6 6 6 6 6 6 6 6 6 6 6 6 6 6 6 6 6 6 6 6 6 6
6 6 6 6 6 6 6 6 6 6 6 6 6 6 6 6 6 6 6 6 6 3 1 1 1 3 3 3 3 3 3 3 3 3 3 3 3 3 3 3 3 3 6 6 6 6 6 6
6 6 6 6 6 6 6 6 6 6 6 6 6 6 6 6 6 6 6 6 6 3 1 1 1 1 1 1 1 1 1 1 1 1 1 1 1 1 1 1 3 3 6 6 6 6 6 6
6 6 6 6 6 6 6 6 6 6 6 6 6 6 6 6 6 6 6 6 6 3 1 1 1 1 1 1 1 1 1 1 1 1 1 1 1 1 1 1 3 3 6 6 6 6 6 6
6 6 6 6 6 6 6 6 6 6 6 6 6 6 6 6 6 6 3 3 3 3 1 1 1 1 1 1 1 1 1 1 1 1 1 1 1 1 1 1 3 3 6 6 6 6 6 6
6 6 6 6 6 6 6 6 6 6 9 3 9 9 6 6 6 3 3 3 3 3 3 3 3 3 3 3 3 3 3 3 3 3 3 3 3 1 1 1 3 3 6 6 6 6 6 6
6 6 6 6 6 6 6 6 6 3 3 9 3 3 3 6 6 3 3 6 6 6 6 6 6 6 6 6 6 6 3 3 3 3 3 3 3 1 1 1 3 3 3 3 3 3 6 6
6 6 6 6 6 6 6 6 6 3 9 3 9 9 3 6 6 3 3 6 6 6 6 6 6 6 6 6 6 6 6 3 3 3 3 3 3 1 1 1 3 3 3 3 3 3 6 6
6 6 6 6 6 6 6 6 6 3 3 9 9 3 3 3 3 3 3 6 6 6 6 6 6 6 6 6 6 6 6 6 6 6 6 3 3 1 1 1 3 3 3 3 3 3 6 6
6 6 6 6 6 6 6 6 6 3 9 3 9 9 3 3 3 3 6 6 6 6 6 6 6 6 6 6 6 6 6 6 6 6 6 3 3 1 1 1 3 3 3 3 3 3 6 6
6 6 6 6 6 6 6 6 6 9 3 9 3 3 9 3 6 6 6 6 6 6 6 6 6 6 6 6 6 6 6 6 6 6 6 3 3 1 1 1 3 3 3 3 3 3 6 6
6 6 6 6 6 6 6 6 6 3 3 9 9 9 3 3 6 6 6 6 6 6 6 6 6 6 6 6 6 6 6 6 6 6 6 3 3 1 1 1 3 3 3 3 3 3 6 6
6 3 3 3 3 6 6 6 6 3 9 3 9 3 9 3 6 6 6 6 6 6 3 3 3 6 6 6 6 6 6 6 6 6 6 3 3 1 1 1 3 3 3 3 3 3 6 6
6 3 3 3 3 6 6 6 6 9 3 3 3 3 3 6 6 6 6 6 6 3 1 1 1 3 6 6 6 6 6 6 6 6 6 3 3 1 1 1 3 3 3 3 3 3 6 6
6 3 3 3 3 6 6 6 6 3 3 6 6 6 6 6 6 6 6 6 3 1 1 1 1 1 3 3 3 3 3 3 3 3 3 3 3 1 1 1 3 3 3 3 3 3 6 6
6 3 3 3 3 6 6 6 6 3 3 6 6 6 6 6 6 6 6 3 1 1 1 1 1 1 1 1 1 1 1 1 1 1 1 1 1 1 1 1 3 3 3 3 3 3 6 6
6 3 3 3 3 3 3 3 3 3 3 6 6 6 6 6 6 6 6 3 1 1 1 7 1 1 1 1 1 1 1 1 1 1 1 1 1 1 1 1 3 3 3 3 3 3 6 6
6 3 3 3 3 3 3 3 3 3 3 6 6 6 6 6 6 6 6 3 1 1 1 1 1 1 1 1 1 1 1 1 1 1 1 1 1 1 1 1 3 3 3 3 3 3 6 6
6 6 6 6 6 6 6 3 3 6 6 6 6 6 6 6 6 6 6 6 3 1 1 1 1 1 3 3 3 3 3 3 3 3 3 3 3 3 3 3 3 3 3 3 3 3 6 6
6 6 6 6 6 6 6 3 3 6 6 6 6 6 6 6 6 6 6 6 3 3 1 1 1 3 6 6 6 6 6 8 6 6 6 6 6 6 6 6 6 6 6 6 6 6 6 6
6 6 6 6 6 6 6 3 3 6 6 6 6 6 6 6 6 6 6 6 3 3 1 1 1 3 6 6 6 6 6 8 6 6 6 6 6 6 6 6 6 6 6 6 6 6 6 6
6 6 6 6 6 6 6 3 3 6 6 6 6 6 6 6 6 3 3 3 3 3 1 1 1 3 6 6 6 6 6 8 6 6 6 6 6 6 6 6 6 6 6 6 6 6 6 6
6 6 6 6 6 6 6 3 3 6 6 6 6 6 6 6 6 3 3 3 3 3 1 1 1 3 6 6 6 6 6 8 6 6 6 6 6 6 6 6 6 3 6 6 6 6 6 6
6 6 6 3 3 3 3 3 3 3 3 3 3 3 3 3 3 3 3 3 3 3 1 1 1 3 6 6 6 6 6 8 8 8 8 8 8 8 8 8 8 3 6 6 6 6 6 6
6 6 6 3 3 3 3 3 3 3 3 3 3 3 3 3 3 3 3 3 3 3 1 1 1 3 3 3 3 6 6 6 6 6 6 6 6 6 6 6 6 6 6 6 6 6 6 6
6 6 6 3 3 3 3 3 3 6 6 6 6 6 6 6 6 6 6 3 3 3 1 1 1 3 3 3 3 3 6 6 6 6 6 6 6 6 6 6 6 6 6 6 6 6 6 6
6 6 6 3 3 3 3 3 3 6 6 6 6 6 6 6 6 6 6 3 3 3 1 3 1 3 3 3 3 3 3 6 6 6 6 6 6 3 3 3 3 3 6 6 6 6 6 6
6 6 6 3 3 3 3 3 3 6 6 6 6 6 6 6 6 6 6 3 3 1 3 3 3 3 3 3 3 3 3 3 3 3 3 3 3 3 3 3 3 3 3 6 6 6 6 6
6 6 6 3 3 3 3 3 3 6 6 6 6 6 6 6 6 6 3 3 3 3 3 3 3 3 3 3 3 3 3 3 3 3 3 3 3 3 3 3 3 3 3 6 6 6 6 6
6 6 6 6 6 6 6 6 6 6 6 6 6 6 6 6 6 3 5 5 5 5 5 5 5 5 5 5 5 3 3 3 3 3 3 3 3 3 3 3 3 3 3 6 6 6 6 6
6 6 6 6 6 6 6 6 6 6 6 6 6 6 6 6 6 5 5 5 5 5 5 5 5 5 5 5 5 5 6 6 6 6 6 6 6 6 6 6 6 6 6 6 6 6 6 6
